# Sample Grid Map for Navigation Behavior Tree Demo
# Format: <width> <height>
# Symbols: . = free, # = obstacle, S = start, G = goal
#           ~ = water (3x cost), , = rough terrain (2x cost)
# Map size: 25 wide x 15 tall
25 15
#########################
#S......................#
#.......................#
#.....#.................#
#.....#..........#......#
#.....#..........#......#
#.....#..........#......#
#..........######.......#
#..,,..........,,.......#
########..........#######
#..............#........#
#..............#........#
#..........#####........#
#..................~~..G#
#########################
